{
  "01d": "☀️",
  "02d": "\ue21d",
  "03d": "\ue268",
  "04d": "",
  "09d": "",
  "10d": "",
  "11d": "",
  "13d": "",
  "50d": "",
  "01n": "",
  "02n": "",
  "03n": "\ue268",
  "04n": "️️",
  "09n": "",
  "10n": "",
  "11n": "",
  "13n": "",
  "50n": ""
}
